GGGGGGGGGGGGGGGGGGGGGGGGGGGGGGGGGGGGGGGGGG
G......................................G
G....P....C...........S........R.......G
G....GGGGGG.....GGGGGG........GGGGGG...G
GGGGGG.................................G
G......................................G
G......................................G
G......................................G
G......................................G
G......................................G
G......................................G
G......................................G
G......................................G
G............................. ........G
G....................GGGG..............G
G......................................G
G......................................G
G.................................GGGGGG
G.................................GGGGGG
G.................................GGGGGG
GGGGGGGGGGGGGGGGGGGGGGGGGGGGGGGGGGGGGGGGGGG