GGGGGGGGGGGGGGGGGGGGGGGGGGGGGGGGGGGGGGGGGG
G........................................G
G....P....C.....W.....S........R.........G
G....GGGGGG.....GGGGGG........GGGGGG.....G
GGGGGG................................GGGG
