GGGGGGGGGGGGGGGGGGGGGGGGGGGGGGGGGGGGGGGGGG
G......................................G
G....P....C.....W.....S........R.......G
G....GGGGGG.....GGGGGG........GGGGGG...G
GGGGGG................................GGG
G......................................G
G......................................G
G......................................G
G......................................G
G......................................G
G......................................G
G......................................G
G......................................G
G......................................G
G......................................G
G......................................G
G......................................G
G......................................G
G......................................G
G......................................G
.......................................G
GGGGGGGGGGGGGGGGGGGGGGGGGGGGGGGGGGGGGGGGGG