GGGGGGGGGGGGGGGGGGGGGGGGGGGGGGGGGGGGGGGGGG
G........................................G
G....P....C.....W.....S........R.........G
G....GGGGGG.....GGGGGG........GGGGGG.....G
GGGGGG................................GGGG
G........................................G
G........................................G
G........................................G
G........................................G
G........................................G
G........................................G
G........................................G
G........................................G
G........................................G
G........................................G
G........................................G
G........................................G
G........................................G
GGGGGGGGGGGGGGGGGGGGGGGGGGGGGGGGGGGGGGGGGG