BBBBBBBBBBBBBBBBBBBBBBBBBBB
BBBBBBBBBBBBBBBBBBBBBBBBBBB
BBBBBBBBBBBBBBBBBBBBBBBBBBB
BBBBBBBB...............BBBB
BBBB...................BBBB
BBBB.......................
BBBB.......................
BBBB.......................
BBBBBBBBBBBBBBBBB......BBBB
BBBBBBBBBBBBBBBBBSSSSSSBBBB
BBBBBBBBBBBBBBBBBBBBBBBBBBB
BBBBBBBBBBBBBBBBBBBBBBBBBBB
BBBBBBBBBBBBBBBBBBBBBBBBBBB