BBBBBBBBBBBBBBBBBBBBBBBBBBB
BBBBBBBBBBBBBBBBBBBBBBBBBBB
BBBBBBBBBBBBBBBBBBBBBBBBBBB
BBBB...................BBBB
BBBB...................BBBB
B......................BBBB
B......................BBBB
B....BBBB..............BBBB
BSS......BBBBBBBB......BBBB
BBB......BBBBBBBBSSSSSSBBBB
B........BBBBBBBBBBBBBBBBBB
BEEEEEEEEBBBBBBBBBBBBBBBBBB
BBBBBBBBBBBBBBBBBBBBBBBBBBB