BBBBBBBBBBBBBBBBBBBBBBBBBBB
BBBBBBBBBBBBBBBBBBBBBBBBBBB
BBBBBBBBBBBBBBBBBBBBBBBBBBB
BBBBBBBB...............BBBB
BBBB...................BBBB
BBBB.......................
BBBB........WWWW...........
BBBB.......................
BBBBBBBBBBB......BBBBBBBBBB
BBBBBBBBBBBSSSSSSBBBBBBBBBB
BBBBBBBBBBBBBBBBBBBBBBBBBBB
BBBBBBBBBBBBBBBBBBBBBBBBBBB
BBBBBBBBBBBBBBBBBBBBBBBBBBB