BBBBBBBBBBBBBBBBBBBBBBBBBBB
BBBBBBBBBBBBBBBBBBBBBBBBBBB
BBBBBBBBBBBBBBBBBBBBBBBBBBB
BBBB...................BBBB
BBBB...................BBBB
E......................BBBB
E......................BBBB
E....BBBB..............BBBB
BBBBBBBBBBBBBBBBB......BBBB
BBBBBBBBBBBBBBBBBSSSSSSBBBB
BBBBBBBBBBBBBBBBBBBBBBBBBBB
BBBBBBBBBBBBBBBBBBBBBBBBBBB
BBBBBBBBBBBBBBBBBBBBBBBBBBB